__________________e___ccc___e____ce___c________c_e___c__c____e_c___c________
__________________e___ccc___e____ce___c________c_e___c__c____e_c___c________
__________________e___ccc___e____ce___c___cc___c_e___c__c____e_c___c________
__________________c___e_e_______ccc___c________c_____c__c______c___c________
__________________e___ccc___e____ce___c__cccc__c_c___c__c______c___c________
__________________cccccccc_e___e_____c_ccccccce___e_ccccc_e_cccc_ecc________
__________________c___ccc___c____cc___c___cc___c_e___c__c____e_c___c________
__________________c___e_e_______ccc___c________c_____c__c____e_c___c________
__________________e___ccc___e____ce___c________c_e___c__c____e_c___c________
____________________________________________________________________________