__________________e___cee___e__e_ce___c_____e__c_e___c__e____e_c___c________
__________________c________e_____e___e___e____c_e___c__c____e_c___c_________
____________________eeccccc_e____c___ee___cc_e_____ce_c____e_c___c__________
___________________e____e_______e_c_e_c__e______e__ee__c______c___c_________
__________________e___ccce_______cee__c__cccc__c_c___c__c______c___c________
___________________c_e____e___e_____c_eeeeeee___e_cccec_e_ce___ecc__________
__________________c_e_ccc___e____cc___c___ec___c_e___ee______e_c___c________
___________________e__e_ee______cce___ç________c_____c__c______c___c________
__________________e___ccc_eee_c_eee_____ee____c_e___c__c____e_c___c_________
____________________________________________________________________________